TTTTTTTT
T..T..FT
TT..T..T
TT.T..TT
T......T
TT.T...T
T....T.T
TTTTTTTT
